"filename", "language", "TypeScript", "TypeScript React", "CSS", "Markdown", "comment", "blank", "total"
"/Users/timothymalcham/dev/DINO-MERCS/src/@types/deep-equal.d.ts", "TypeScript", 1, 0, 0, 0, 0, 1, 2
"/Users/timothymalcham/dev/DINO-MERCS/src/@types/react-aria-tooltip.d.ts", "TypeScript", 1, 0, 0, 0, 0, 1, 2
"/Users/timothymalcham/dev/DINO-MERCS/src/@types/react-typist.d.ts", "TypeScript", 1, 0, 0, 0, 0, 1, 2
"/Users/timothymalcham/dev/DINO-MERCS/src/App.tsx", "TypeScript React", 0, 17, 0, 0, 0, 4, 21
"/Users/timothymalcham/dev/DINO-MERCS/src/Game.tsx", "TypeScript React", 0, 116, 0, 0, 7, 10, 133
"/Users/timothymalcham/dev/DINO-MERCS/src/assets/styles/index.css", "CSS", 0, 0, 531, 0, 406, 117, 1054
"/Users/timothymalcham/dev/DINO-MERCS/src/cards/baseDefense/README.md", "Markdown", 0, 0, 0, 36, 0, 19, 55
"/Users/timothymalcham/dev/DINO-MERCS/src/cards/baseDefense/baseDefenseCards.ts", "TypeScript", 90, 0, 0, 0, 0, 16, 106
"/Users/timothymalcham/dev/DINO-MERCS/src/cards/baseDefense/cards/attackers/airStrike.ts", "TypeScript", 76, 0, 0, 0, 0, 3, 79
"/Users/timothymalcham/dev/DINO-MERCS/src/cards/baseDefense/cards/attackers/attackVtol.ts", "TypeScript", 76, 0, 0, 0, 0, 3, 79
"/Users/timothymalcham/dev/DINO-MERCS/src/cards/baseDefense/cards/attackers/groundTroops.ts", "TypeScript", 76, 0, 0, 0, 0, 3, 79
"/Users/timothymalcham/dev/DINO-MERCS/src/cards/baseDefense/cards/attackers/index.ts", "TypeScript", 10, 0, 0, 0, 0, 2, 12
"/Users/timothymalcham/dev/DINO-MERCS/src/cards/baseDefense/cards/attackers/rapidAssaultMech.ts", "TypeScript", 76, 0, 0, 0, 0, 3, 79
"/Users/timothymalcham/dev/DINO-MERCS/src/cards/baseDefense/cards/baseDefenseEvent.ts", "TypeScript", 67, 0, 0, 0, 0, 3, 70
"/Users/timothymalcham/dev/DINO-MERCS/src/cards/baseDefense/cards/cargoDrop.ts", "TypeScript", 65, 0, 0, 0, 0, 3, 68
"/Users/timothymalcham/dev/DINO-MERCS/src/cards/baseDefense/cards/competitionKiller.ts", "TypeScript", 84, 0, 0, 0, 0, 3, 87
"/Users/timothymalcham/dev/DINO-MERCS/src/cards/baseDefense/cards/enhancedSystems.ts", "TypeScript", 87, 0, 0, 0, 0, 3, 90
"/Users/timothymalcham/dev/DINO-MERCS/src/cards/baseDefense/cards/entrench.ts", "TypeScript", 90, 0, 0, 0, 0, 3, 93
"/Users/timothymalcham/dev/DINO-MERCS/src/cards/baseDefense/cards/expeditedRepairs.ts", "TypeScript", 78, 0, 0, 0, 0, 3, 81
"/Users/timothymalcham/dev/DINO-MERCS/src/cards/baseDefense/cards/feast.ts", "TypeScript", 90, 0, 0, 0, 0, 3, 93
"/Users/timothymalcham/dev/DINO-MERCS/src/cards/baseDefense/cards/firefighters.ts", "TypeScript", 72, 0, 0, 0, 0, 3, 75
"/Users/timothymalcham/dev/DINO-MERCS/src/cards/baseDefense/cards/freshBatch.ts", "TypeScript", 72, 0, 0, 0, 0, 3, 75
"/Users/timothymalcham/dev/DINO-MERCS/src/cards/baseDefense/cards/gambit.ts", "TypeScript", 87, 0, 0, 0, 0, 3, 90
"/Users/timothymalcham/dev/DINO-MERCS/src/cards/baseDefense/cards/generateRevenue.ts", "TypeScript", 71, 0, 0, 0, 0, 3, 74
"/Users/timothymalcham/dev/DINO-MERCS/src/cards/baseDefense/cards/incendiaryBarrage.ts", "TypeScript", 72, 0, 0, 0, 0, 3, 75
"/Users/timothymalcham/dev/DINO-MERCS/src/cards/baseDefense/cards/muchNeededRepairs.ts", "TypeScript", 78, 0, 0, 0, 0, 3, 81
"/Users/timothymalcham/dev/DINO-MERCS/src/cards/baseDefense/cards/rally.ts", "TypeScript", 87, 0, 0, 0, 0, 3, 90
"/Users/timothymalcham/dev/DINO-MERCS/src/cards/baseDefense/cards/severeStorm.ts", "TypeScript", 69, 0, 0, 0, 0, 3, 72
"/Users/timothymalcham/dev/DINO-MERCS/src/cards/baseDefense/starterDeck.ts", "TypeScript", 24, 0, 0, 0, 2, 12, 38
"/Users/timothymalcham/dev/DINO-MERCS/src/cards/combat/README.md", "Markdown", 0, 0, 0, 122, 0, 15, 137
"/Users/timothymalcham/dev/DINO-MERCS/src/cards/combat/cards/blazingSun.ts", "TypeScript", 72, 0, 0, 0, 0, 3, 75
"/Users/timothymalcham/dev/DINO-MERCS/src/cards/combat/cards/chargeShield.ts", "TypeScript", 77, 0, 0, 0, 0, 3, 80
"/Users/timothymalcham/dev/DINO-MERCS/src/cards/combat/cards/closeAirSupport.ts", "TypeScript", 72, 0, 0, 0, 0, 3, 75
"/Users/timothymalcham/dev/DINO-MERCS/src/cards/combat/cards/combatArmor.ts", "TypeScript", 62, 0, 0, 0, 0, 3, 65
"/Users/timothymalcham/dev/DINO-MERCS/src/cards/combat/cards/cruelBlade.ts", "TypeScript", 95, 0, 0, 0, 0, 3, 98
"/Users/timothymalcham/dev/DINO-MERCS/src/cards/combat/cards/digIn.ts", "TypeScript", 63, 0, 0, 0, 0, 3, 66
"/Users/timothymalcham/dev/DINO-MERCS/src/cards/combat/cards/displayOfForce.ts", "TypeScript", 66, 0, 0, 0, 0, 3, 69
"/Users/timothymalcham/dev/DINO-MERCS/src/cards/combat/cards/dizziedStrike.ts", "TypeScript", 95, 0, 0, 0, 0, 3, 98
"/Users/timothymalcham/dev/DINO-MERCS/src/cards/combat/cards/energyBlast.ts", "TypeScript", 116, 0, 0, 0, 0, 3, 119
"/Users/timothymalcham/dev/DINO-MERCS/src/cards/combat/cards/fireFlail.ts", "TypeScript", 108, 0, 0, 0, 0, 3, 111
"/Users/timothymalcham/dev/DINO-MERCS/src/cards/combat/cards/flamethrower.ts", "TypeScript", 92, 0, 0, 0, 0, 3, 95
"/Users/timothymalcham/dev/DINO-MERCS/src/cards/combat/cards/flamingBile.ts", "TypeScript", 95, 0, 0, 0, 0, 3, 98
"/Users/timothymalcham/dev/DINO-MERCS/src/cards/combat/cards/flashbang.ts", "TypeScript", 72, 0, 0, 0, 0, 3, 75
"/Users/timothymalcham/dev/DINO-MERCS/src/cards/combat/cards/fragGrenade.ts", "TypeScript", 100, 0, 0, 0, 0, 3, 103
"/Users/timothymalcham/dev/DINO-MERCS/src/cards/combat/cards/fullMetalJacket.ts", "TypeScript", 102, 0, 0, 0, 0, 3, 105
"/Users/timothymalcham/dev/DINO-MERCS/src/cards/combat/cards/guidedMissile.ts", "TypeScript", 102, 0, 0, 0, 0, 3, 105
"/Users/timothymalcham/dev/DINO-MERCS/src/cards/combat/cards/illogicalCourage.ts", "TypeScript", 95, 0, 0, 0, 0, 3, 98
"/Users/timothymalcham/dev/DINO-MERCS/src/cards/combat/cards/laserStrike.ts", "TypeScript", 105, 0, 0, 0, 0, 3, 108
"/Users/timothymalcham/dev/DINO-MERCS/src/cards/combat/cards/laserSword.ts", "TypeScript", 90, 0, 0, 0, 0, 3, 93
"/Users/timothymalcham/dev/DINO-MERCS/src/cards/combat/cards/medivac.ts", "TypeScript", 65, 0, 0, 0, 0, 3, 68
"/Users/timothymalcham/dev/DINO-MERCS/src/cards/combat/cards/mobileShieldBattery.ts", "TypeScript", 66, 0, 0, 0, 0, 3, 69
"/Users/timothymalcham/dev/DINO-MERCS/src/cards/combat/cards/panicButton.ts", "TypeScript", 78, 0, 0, 0, 0, 3, 81
"/Users/timothymalcham/dev/DINO-MERCS/src/cards/combat/cards/rpg.ts", "TypeScript", 111, 0, 0, 0, 0, 3, 114
"/Users/timothymalcham/dev/DINO-MERCS/src/cards/combat/cards/shattered.ts", "TypeScript", 63, 0, 0, 0, 0, 3, 66
"/Users/timothymalcham/dev/DINO-MERCS/src/cards/combat/cards/shieldOverload.ts", "TypeScript", 107, 0, 0, 0, 0, 3, 110
"/Users/timothymalcham/dev/DINO-MERCS/src/cards/combat/cards/sliceAndDice.ts", "TypeScript", 71, 0, 0, 0, 0, 3, 74
"/Users/timothymalcham/dev/DINO-MERCS/src/cards/combat/cards/smokeGrenade.ts", "TypeScript", 70, 0, 0, 0, 0, 3, 73
"/Users/timothymalcham/dev/DINO-MERCS/src/cards/combat/cards/snapOutOfIt.ts", "TypeScript", 99, 0, 0, 0, 0, 3, 102
"/Users/timothymalcham/dev/DINO-MERCS/src/cards/combat/cards/standardIssueRifle.ts", "TypeScript", 96, 0, 0, 0, 0, 3, 99
"/Users/timothymalcham/dev/DINO-MERCS/src/cards/combat/cards/suppressiveFire.ts", "TypeScript", 57, 0, 0, 0, 0, 3, 60
"/Users/timothymalcham/dev/DINO-MERCS/src/cards/combat/cards/thermalSights.ts", "TypeScript", 72, 0, 0, 0, 0, 3, 75
"/Users/timothymalcham/dev/DINO-MERCS/src/cards/combat/cards/trustySidearm.ts", "TypeScript", 65, 0, 0, 0, 0, 3, 68
"/Users/timothymalcham/dev/DINO-MERCS/src/cards/combat/cards/wallbang.ts", "TypeScript", 63, 0, 0, 0, 0, 3, 66
"/Users/timothymalcham/dev/DINO-MERCS/src/cards/combat/combatCards.ts", "TypeScript", 267, 0, 0, 0, 0, 32, 299
"/Users/timothymalcham/dev/DINO-MERCS/src/cards/combat/starterDeck.ts", "TypeScript", 25, 0, 0, 0, 0, 4, 29
"/Users/timothymalcham/dev/DINO-MERCS/src/cards/constants.ts", "TypeScript", 1, 0, 0, 0, 0, 1, 2
"/Users/timothymalcham/dev/DINO-MERCS/src/cards/enemy/carcharodontosaurus.ts", "TypeScript", 231, 0, 0, 0, 0, 8, 239
"/Users/timothymalcham/dev/DINO-MERCS/src/cards/enemy/carnotaurus.ts", "TypeScript", 411, 0, 0, 0, 0, 15, 426
"/Users/timothymalcham/dev/DINO-MERCS/src/cards/enemy/cryolophosaurus.ts", "TypeScript", 242, 0, 0, 0, 0, 8, 250
"/Users/timothymalcham/dev/DINO-MERCS/src/cards/enemy/gallimimus.ts", "TypeScript", 214, 0, 0, 0, 0, 8, 222
"/Users/timothymalcham/dev/DINO-MERCS/src/cards/enemy/mercuriceratops.ts", "TypeScript", 178, 0, 0, 0, 0, 6, 184
"/Users/timothymalcham/dev/DINO-MERCS/src/cards/enemy/pachycephalosaurus.ts", "TypeScript", 227, 0, 0, 0, 0, 8, 235
"/Users/timothymalcham/dev/DINO-MERCS/src/cards/enemy/styracosaurus.ts", "TypeScript", 249, 0, 0, 0, 0, 8, 257
"/Users/timothymalcham/dev/DINO-MERCS/src/cards/operation/cards/allIn.ts", "TypeScript", 76, 0, 0, 0, 0, 3, 79
"/Users/timothymalcham/dev/DINO-MERCS/src/cards/operation/cards/blockade.ts", "TypeScript", 51, 0, 0, 0, 0, 3, 54
"/Users/timothymalcham/dev/DINO-MERCS/src/cards/operation/cards/combatCare.ts", "TypeScript", 62, 0, 0, 0, 0, 3, 65
"/Users/timothymalcham/dev/DINO-MERCS/src/cards/operation/cards/combatEncounter.ts", "TypeScript", 86, 0, 0, 0, 0, 3, 89
"/Users/timothymalcham/dev/DINO-MERCS/src/cards/operation/cards/deadlyArsenal.ts", "TypeScript", 72, 0, 0, 0, 0, 3, 75
"/Users/timothymalcham/dev/DINO-MERCS/src/cards/operation/cards/landMine.ts", "TypeScript", 79, 0, 0, 0, 0, 3, 82
"/Users/timothymalcham/dev/DINO-MERCS/src/cards/operation/cards/operationEvent.ts", "TypeScript", 61, 0, 0, 0, 0, 3, 64
"/Users/timothymalcham/dev/DINO-MERCS/src/cards/operation/cards/raiderAmbush.ts", "TypeScript", 76, 0, 0, 0, 0, 3, 79
"/Users/timothymalcham/dev/DINO-MERCS/src/cards/operation/cards/rapidDeployment.ts", "TypeScript", 65, 0, 0, 0, 0, 3, 68
"/Users/timothymalcham/dev/DINO-MERCS/src/cards/operation/cards/scavenger.ts", "TypeScript", 69, 0, 0, 0, 0, 3, 72
"/Users/timothymalcham/dev/DINO-MERCS/src/cards/operation/cards/spikePitTrap.ts", "TypeScript", 79, 0, 0, 0, 0, 3, 82
"/Users/timothymalcham/dev/DINO-MERCS/src/cards/operation/cards/spoilsOfWar.ts", "TypeScript", 76, 0, 0, 0, 0, 3, 79
"/Users/timothymalcham/dev/DINO-MERCS/src/cards/operation/cards/swindle.ts", "TypeScript", 75, 0, 0, 0, 0, 3, 78
"/Users/timothymalcham/dev/DINO-MERCS/src/cards/operation/cards/thievingBandits.ts", "TypeScript", 76, 0, 0, 0, 0, 3, 79
"/Users/timothymalcham/dev/DINO-MERCS/src/cards/operation/operationCards.ts", "TypeScript", 63, 0, 0, 0, 0, 14, 77
"/Users/timothymalcham/dev/DINO-MERCS/src/cards/operation/starterDeck.ts", "TypeScript", 11, 0, 0, 0, 0, 5, 16
"/Users/timothymalcham/dev/DINO-MERCS/src/components/GameContainer.tsx", "TypeScript React", 0, 4, 0, 0, 0, 2, 6
"/Users/timothymalcham/dev/DINO-MERCS/src/components/GameModeModal.tsx", "TypeScript React", 0, 162, 0, 0, 0, 9, 171
"/Users/timothymalcham/dev/DINO-MERCS/src/components/SoundEffects.tsx", "TypeScript React", 0, 91, 0, 0, 0, 8, 99
"/Users/timothymalcham/dev/DINO-MERCS/src/components/screens/BaseScreen.tsx", "TypeScript React", 0, 119, 0, 0, 12, 6, 137
"/Users/timothymalcham/dev/DINO-MERCS/src/components/screens/CharacterSelectionScreen.tsx", "TypeScript React", 0, 184, 0, 0, 0, 12, 196
"/Users/timothymalcham/dev/DINO-MERCS/src/components/screens/GameOverScreen.tsx", "TypeScript React", 0, 135, 0, 0, 0, 15, 150
"/Users/timothymalcham/dev/DINO-MERCS/src/components/screens/IntroScreen.tsx", "TypeScript React", 0, 150, 0, 0, 0, 7, 157
"/Users/timothymalcham/dev/DINO-MERCS/src/components/screens/StartScreen.tsx", "TypeScript React", 0, 80, 0, 0, 0, 10, 90
"/Users/timothymalcham/dev/DINO-MERCS/src/components/screens/Tutorial.tsx", "TypeScript React", 0, 346, 0, 0, 1, 13, 360
"/Users/timothymalcham/dev/DINO-MERCS/src/components/screens/baseDefense/AsyncBaseDefenseBoundary.tsx", "TypeScript React", 0, 8, 0, 0, 0, 4, 12
"/Users/timothymalcham/dev/DINO-MERCS/src/components/screens/baseDefense/BaseDefenseCardOverlay.tsx", "TypeScript React", 0, 163, 0, 0, 0, 18, 181
"/Users/timothymalcham/dev/DINO-MERCS/src/components/screens/baseDefense/BaseDefenseContent.tsx", "TypeScript React", 0, 4, 0, 0, 0, 2, 6
"/Users/timothymalcham/dev/DINO-MERCS/src/components/screens/baseDefense/BaseDefenseFooter.tsx", "TypeScript React", 0, 206, 0, 0, 1, 14, 221
"/Users/timothymalcham/dev/DINO-MERCS/src/components/screens/baseDefense/BaseDefenseHeader.tsx", "TypeScript React", 0, 84, 0, 0, 0, 7, 91
"/Users/timothymalcham/dev/DINO-MERCS/src/components/screens/baseDefense/BaseDefenseIntroScreen.tsx", "TypeScript React", 0, 141, 0, 0, 0, 10, 151
"/Users/timothymalcham/dev/DINO-MERCS/src/components/screens/baseDefense/BaseDefenseLoadingScreen.tsx", "TypeScript React", 0, 200, 0, 0, 0, 27, 227
"/Users/timothymalcham/dev/DINO-MERCS/src/components/screens/baseDefense/BaseDefenseMain.tsx", "TypeScript React", 0, 67, 0, 0, 0, 10, 77
"/Users/timothymalcham/dev/DINO-MERCS/src/components/screens/baseDefense/BaseDefenseMiddleContent.tsx", "TypeScript React", 0, 132, 0, 0, 0, 18, 150
"/Users/timothymalcham/dev/DINO-MERCS/src/components/screens/baseDefense/BaseDefenseRewardsScreen.tsx", "TypeScript React", 0, 221, 0, 0, 0, 15, 236
"/Users/timothymalcham/dev/DINO-MERCS/src/components/screens/baseDefense/BaseDefenseScreen.tsx", "TypeScript React", 0, 17, 0, 0, 0, 4, 21
"/Users/timothymalcham/dev/DINO-MERCS/src/components/screens/combat/AsyncCombatBoundary.tsx", "TypeScript React", 0, 8, 0, 0, 0, 4, 12
"/Users/timothymalcham/dev/DINO-MERCS/src/components/screens/combat/CombatFooter.tsx", "TypeScript React", 0, 218, 0, 0, 1, 15, 234
"/Users/timothymalcham/dev/DINO-MERCS/src/components/screens/combat/CombatIntroScreen.tsx", "TypeScript React", 0, 145, 0, 0, 0, 10, 155
"/Users/timothymalcham/dev/DINO-MERCS/src/components/screens/combat/CombatLoadingScreen.tsx", "TypeScript React", 0, 46, 0, 0, 0, 6, 52
"/Users/timothymalcham/dev/DINO-MERCS/src/components/screens/combat/CombatMain.tsx", "TypeScript React", 0, 4, 0, 0, 0, 2, 6
"/Users/timothymalcham/dev/DINO-MERCS/src/components/screens/combat/CombatMiddleContent.tsx", "TypeScript React", 0, 153, 0, 0, 0, 20, 173
"/Users/timothymalcham/dev/DINO-MERCS/src/components/screens/combat/CombatRewardsScreen.tsx", "TypeScript React", 0, 210, 0, 0, 0, 14, 224
"/Users/timothymalcham/dev/DINO-MERCS/src/components/screens/combat/CombatScreen.tsx", "TypeScript React", 0, 70, 0, 0, 0, 8, 78
"/Users/timothymalcham/dev/DINO-MERCS/src/components/screens/combat/CombatScreenHeader.tsx", "TypeScript React", 0, 78, 0, 0, 0, 7, 85
"/Users/timothymalcham/dev/DINO-MERCS/src/components/screens/combat/DeathMessageOverlay.tsx", "TypeScript React", 0, 14, 0, 0, 0, 5, 19
"/Users/timothymalcham/dev/DINO-MERCS/src/components/screens/missionCompleteScreen.tsx", "TypeScript React", 0, 141, 0, 0, 0, 15, 156
"/Users/timothymalcham/dev/DINO-MERCS/src/components/screens/operation/AsyncOperationBoundary.tsx", "TypeScript React", 0, 8, 0, 0, 0, 4, 12
"/Users/timothymalcham/dev/DINO-MERCS/src/components/screens/operation/Main.tsx", "TypeScript React", 0, 4, 0, 0, 0, 2, 6
"/Users/timothymalcham/dev/DINO-MERCS/src/components/screens/operation/OperationFooter.tsx", "TypeScript React", 0, 183, 0, 0, 1, 16, 200
"/Users/timothymalcham/dev/DINO-MERCS/src/components/screens/operation/OperationIntroScreen.tsx", "TypeScript React", 0, 198, 0, 0, 0, 9, 207
"/Users/timothymalcham/dev/DINO-MERCS/src/components/screens/operation/OperationMiddleContent.tsx", "TypeScript React", 0, 247, 0, 0, 0, 28, 275
"/Users/timothymalcham/dev/DINO-MERCS/src/components/screens/operation/OperationRewardsScreen.tsx", "TypeScript React", 0, 178, 0, 0, 0, 11, 189
"/Users/timothymalcham/dev/DINO-MERCS/src/components/screens/operation/OperationScreen.tsx", "TypeScript React", 0, 45, 0, 0, 1, 6, 52
"/Users/timothymalcham/dev/DINO-MERCS/src/components/screens/operation/OperationScreenHeader.tsx", "TypeScript React", 0, 77, 0, 0, 0, 7, 84
"/Users/timothymalcham/dev/DINO-MERCS/src/components/shared/AnimatedList.tsx", "TypeScript React", 0, 157, 0, 0, 0, 9, 166
"/Users/timothymalcham/dev/DINO-MERCS/src/components/shared/Avatar.tsx", "TypeScript React", 0, 76, 0, 0, 0, 5, 81
"/Users/timothymalcham/dev/DINO-MERCS/src/components/shared/Barks.tsx", "TypeScript React", 0, 92, 0, 0, 0, 9, 101
"/Users/timothymalcham/dev/DINO-MERCS/src/components/shared/Button.tsx", "TypeScript React", 0, 68, 0, 0, 0, 6, 74
"/Users/timothymalcham/dev/DINO-MERCS/src/components/shared/Card.tsx", "TypeScript React", 0, 496, 0, 0, 3, 28, 527
"/Users/timothymalcham/dev/DINO-MERCS/src/components/shared/ConfirmationModal.tsx", "TypeScript React", 0, 104, 0, 0, 0, 5, 109
"/Users/timothymalcham/dev/DINO-MERCS/src/components/shared/DeckModal.tsx", "TypeScript React", 0, 111, 0, 0, 0, 7, 118
"/Users/timothymalcham/dev/DINO-MERCS/src/components/shared/ErrorBoundary.tsx", "TypeScript React", 0, 25, 0, 0, 1, 9, 35
"/Users/timothymalcham/dev/DINO-MERCS/src/components/shared/EventModal.tsx", "TypeScript React", 0, 96, 0, 0, 0, 9, 105
"/Users/timothymalcham/dev/DINO-MERCS/src/components/shared/FetchModal.tsx", "TypeScript React", 0, 129, 0, 0, 0, 9, 138
"/Users/timothymalcham/dev/DINO-MERCS/src/components/shared/GameSavedMessage.tsx", "TypeScript React", 0, 51, 0, 0, 0, 7, 58
"/Users/timothymalcham/dev/DINO-MERCS/src/components/shared/Hand.tsx", "TypeScript React", 0, 212, 0, 0, 1, 11, 224
"/Users/timothymalcham/dev/DINO-MERCS/src/components/shared/Img.tsx", "TypeScript React", 0, 47, 0, 0, 0, 3, 50
"/Users/timothymalcham/dev/DINO-MERCS/src/components/shared/LazyImg.tsx", "TypeScript React", 0, 46, 0, 0, 0, 4, 50
"/Users/timothymalcham/dev/DINO-MERCS/src/components/shared/LazyVideo.tsx", "TypeScript React", 0, 18, 0, 0, 3, 2, 23
"/Users/timothymalcham/dev/DINO-MERCS/src/components/shared/MenuModal.tsx", "TypeScript React", 0, 190, 0, 0, 0, 12, 202
"/Users/timothymalcham/dev/DINO-MERCS/src/components/shared/ScreenHeader.tsx", "TypeScript React", 0, 86, 0, 0, 1, 7, 94
"/Users/timothymalcham/dev/DINO-MERCS/src/components/shared/SoundTrack.tsx", "TypeScript React", 0, 89, 0, 0, 4, 16, 109
"/Users/timothymalcham/dev/DINO-MERCS/src/components/shared/Tooltip.tsx", "TypeScript React", 0, 108, 0, 0, 0, 11, 119
"/Users/timothymalcham/dev/DINO-MERCS/src/components/shared/Typer.tsx", "TypeScript React", 0, 26, 0, 0, 0, 3, 29
"/Users/timothymalcham/dev/DINO-MERCS/src/components/shared/VideoBackground.tsx", "TypeScript React", 0, 15, 0, 0, 1, 4, 20
"/Users/timothymalcham/dev/DINO-MERCS/src/components/shared/styled/BaseDefenseScreenBackground.tsx", "TypeScript React", 0, 25, 0, 0, 0, 3, 28
"/Users/timothymalcham/dev/DINO-MERCS/src/components/shared/styled/CombatScreenBackground.tsx", "TypeScript React", 0, 25, 0, 0, 0, 3, 28
"/Users/timothymalcham/dev/DINO-MERCS/src/components/shared/styled/ControlButton.tsx", "TypeScript React", 0, 18, 0, 0, 0, 3, 21
"/Users/timothymalcham/dev/DINO-MERCS/src/components/shared/styled/OperationScreenBackground.tsx", "TypeScript React", 0, 61, 0, 0, 0, 5, 66
"/Users/timothymalcham/dev/DINO-MERCS/src/components/shared/styled/StyledStatBars.tsx", "TypeScript React", 0, 249, 0, 0, 0, 13, 262
"/Users/timothymalcham/dev/DINO-MERCS/src/engine/game/constants.ts", "TypeScript", 528, 0, 0, 0, 7, 24, 559
"/Users/timothymalcham/dev/DINO-MERCS/src/engine/game/context.tsx", "TypeScript React", 0, 38, 0, 0, 4, 10, 52
"/Users/timothymalcham/dev/DINO-MERCS/src/engine/game/gameData.ts", "TypeScript", 9, 0, 0, 0, 0, 5, 14
"/Users/timothymalcham/dev/DINO-MERCS/src/engine/game/guards.ts", "TypeScript", 16, 0, 0, 0, 0, 11, 27
"/Users/timothymalcham/dev/DINO-MERCS/src/engine/game/initialContext.ts", "TypeScript", 126, 0, 0, 0, 0, 3, 129
"/Users/timothymalcham/dev/DINO-MERCS/src/engine/game/machine.tsx", "TypeScript React", 0, 1311, 0, 0, 0, 14, 1325
"/Users/timothymalcham/dev/DINO-MERCS/src/engine/game/model.ts", "TypeScript", 1946, 0, 0, 0, 29, 144, 2119
"/Users/timothymalcham/dev/DINO-MERCS/src/engine/game/selectors.ts", "TypeScript", 76, 0, 0, 0, 6, 10, 92
"/Users/timothymalcham/dev/DINO-MERCS/src/global.d.ts", "TypeScript", 8, 0, 0, 0, 1, 2, 11
"/Users/timothymalcham/dev/DINO-MERCS/src/main.tsx", "TypeScript React", 0, 49, 0, 0, 0, 6, 55
"/Users/timothymalcham/dev/DINO-MERCS/src/seeds/index.ts", "TypeScript", 3, 0, 0, 0, 0, 2, 5
"/Users/timothymalcham/dev/DINO-MERCS/src/seeds/seed_02.ts", "TypeScript", 122, 0, 0, 0, 0, 2, 124
"/Users/timothymalcham/dev/DINO-MERCS/src/seeds/seed_support.ts", "TypeScript", 120, 0, 0, 0, 0, 2, 122
"/Users/timothymalcham/dev/DINO-MERCS/src/types.ts", "TypeScript", 429, 0, 0, 0, 13, 52, 494
"/Users/timothymalcham/dev/DINO-MERCS/src/utils/colors.ts", "TypeScript", 19, 0, 0, 0, 4, 4, 27
"/Users/timothymalcham/dev/DINO-MERCS/src/utils/constants.ts", "TypeScript", 353, 0, 0, 0, 1, 9, 363
"/Users/timothymalcham/dev/DINO-MERCS/src/utils/enemies.ts", "TypeScript", 761, 0, 0, 0, 3, 12, 776
"/Users/timothymalcham/dev/DINO-MERCS/src/utils/helpers.ts", "TypeScript", 772, 0, 0, 0, 50, 124, 946
"/Users/timothymalcham/dev/DINO-MERCS/src/utils/maps/imageMaps/cards.ts", "TypeScript", 95, 0, 0, 0, 8, 8, 111
"/Users/timothymalcham/dev/DINO-MERCS/src/utils/ui.ts", "TypeScript", 23, 0, 0, 0, 0, 7, 30
"/Users/timothymalcham/dev/DINO-MERCS/src/vite-env.d.ts", "TypeScript", 0, 0, 0, 0, 1, 1, 2
"Total", "-", 12890, 8692, 531, 158, 573, 1568, 24412